 9 15
***************
*      *      *
*** ******* * *
* *         * *
* * **  *** * *
*   *     * * *
* ***** * * * *
*      s*  *f *
***************