5 5
*****
*s* *
* * *
*  f*
*****
